5 4 17 61 296 14 
5 7 14 84 188 279 2 237 20 
5 5 20 515 1 361 563 
5 14 149 385 118 442 414 430 597 456 381 243 595 162 425 12 
5 19 12 608 461 495 368 113 484 508 251 300 373 51 289 4 301 627 102 100 369 
5 15 595 35 341 348 581 119 522 222 584 228 192 80 204 60 99 
5 7 162 55 167 293 433 105 383 
5 4 595 263 106 592 
5 5 348 455 568 157 232 
5 4 192 462 66 96 
5 2 358 23 
5 4 200 586 587 222 
1 4 248 624 131 23 
1 6 23 358 196 205 306 250 
5 14 484 221 342 284 509 422 357 9 89 573 511 402 203 131 
1 2 149 89 
5 2 89 149 
3 2 332 465 
1 6 337 475 417 6 384 121 
1 2 226 562 
4 3 99 47 282 
5 4 282 146 576 192 
4 5 197 370 533 377 200 
4 4 146 335 40 377 
5 13 197 574 345 13 493 77 273 126 527 441 168 397 48 
5 18 369 628 330 107 526 491 154 261 366 233 269 321 76 458 124 534 176 273 
5 22 269 621 292 567 187 255 530 114 629 299 52 43 325 82 388 53 28 482 120 446 70 440 
5 11 383 97 272 291 411 359 242 622 159 177 526 
2 9 13 559 145 589 504 585 15 103 282 
5 2 440 224 
