5 4 17 61 296 14 
5 7 14 84 188 279 2 237 20 
5 5 20 515 1 361 563 
5 14 149 385 118 442 414 430 597 456 381 243 595 162 425 12 
5 19 12 608 461 495 368 113 484 508 251 300 373 51 289 4 301 627 102 100 369 
5 21 12 580 435 611 352 347 194 246 209 195 485 287 159 111 154 261 230 382 76 458 124 
5 7 358 203 402 486 179 89 149 
5 22 76 321 269 621 292 498 182 294 170 239 52 500 82 388 53 28 482 446 120 423 525 579 
5 15 595 35 341 348 581 119 522 222 584 228 192 80 204 60 99 
